########################################
#......................................#
#......................................#
#......................................#
#......................................#
#......................................#
#......................................#
#......................................#
#......................................#
#......................................#
#......................................#
#......................................#
#......................................#
#......................................#
#......................................#
#......................................#
#......................................#
#......................................#
#......................................#
#......................................#
#......................................#
#......................................#
######............................######
#....#............................#....#
#....#............................#....#
#....#............................#....#
#....#............................#....#
#....#T..T####################T..T#....#
#....######..................######....#
#......................................#
