########################################
#......................................#
#......................................#
#......................................#
#......................................#
#......................................#
#......................................#
#......................................#
#......................................#
#......................................#
#......................................#
#.......^^######........######^^.......#
#.........#....#........#....#.........#
#.........#....#........#....#.........#
#....######....#........#....######....#
#....#.........#........#.........#....#
#..^^#.........#........#.........#^^..#
#....#.........#T......T#.........#....#
#....#.........##########.........#....#
#..^^#............................#^^..#
#....#............................#....#
#....#............................#....#
#..^^#............................#^^..#
#....#............................#....#
#....#............................#....#
#..^^#............................#^^..#
#....#............................#....#
#....#............................#....#
######............................######
#......................................#
